********************************
*                              *
*                              *
*                     A        *
*                              *
*                              *
*                              *
*                              *
*                              *
*                              *
******       *********    ******
*                              *
*               S              *
*                              *
*                              *
*                              *
*                              *
*                              *
*                              *
*                              *
*                              *
*                              *
*                              *
*                              *
*                              *
*          B                   *
*                              *
*                              *
*                              *
*                              *
*                              *
********************************